Day,Market Participant,Tape A Shares,Tape B Shares,Tape C Shares,Total Shares,Tape A Notional,Tape B Notional,Tape C Notional,Total Notional,Tape A Trade Count,Tape B Trade Count,Tape C Trade Count,Total Trade Count
2009-01,ADF (D),807171027,88279720,261940038,1157390785,17828914811.0,3491408577.79,4868317888.97,26188641277.8,3128570,256690,1011640,4396900
2009-01,AMEX (A),0,247721711,0,247721711,0.0,999868154.32,0.0,999868154.32,0,441688,0,441688
2009-01,BATS (Z),9651035975,6123626144,4441510126,20216172245,220359028544.0,262986137328.0,85818752744.1,569163918617.0,68518100,28335854,27487172,124341126
2009-01,BEX (B),9714881,38783578,6025864,54524323,104238927.6,1465365032.95,173505888.693,1743109849.24,26006,118437,23743,168186
2009-01,CBOE (W),53031000,207685300,58131700,318848000,1287607227.41,11554749998.2,1556025260.24,14398382485.8,80939,253947,179670,514556
2009-01,CHX (M),404650595,252552636,131481384,788684615,10232158503.7,15500510861.1,3391251653.72,29123921018.6,711552,133418,170514,1015484
2009-01,ISE (I),1452271984,442312778,563620938,2458205700,23376128156.6,11651896727.5,7951122865.03,42979147749.1,5496501,998221,2036043,8530765
2009-01,NASDAQ (DQ),26807230997,9750359204,12311400233,48868990434,462836416573.0,319140924198.0,195275462528.0,977252803299.0,68681091,15255926,27904288,111841305
2009-01,NASDAQ (Q),21865690007,12831099600,16364868534,51061658141,462050326107.0,572086795312.0,316175609131.0,1.35031273055e+12,126582571,45425013,70632012,242639596
2009-01,NSX (C),729516918,165073162,267128055,1161718135,13674595912.0,4782031243.68,5319927328.41,23776554484.1,2913477,291954,1132206,4337637
2009-01,NYSE (DN),183654582,20466744,148118000,352239326,3576094019.06,655423692.615,2205593753.29,6437111464.96,424187,35359,343328,802874
2009-01,NYSE (N),27972200218,300,29500,27972230018,596094873851.0,1872.5,544478.0,596095420201.0,93844563,3,73,93844639
2009-01,NYSE Arca (P),16709312603,10547253244,6473896689,33730462536,356003132135.0,424250962531.0,128185508942.0,908439603607.0,99118913,33704571,33568570,166392054
2009-02,ADF (D),848891118,93242883,275914705,1218048706,15945413708.3,3728206349.33,4662136561.46,24335756619.1,3047638,298782,1044598,4391018
2009-02,AMEX (A),0,226128538,0,226128538,0.0,974372028.54,0.0,974372028.54,0,422214,0,422214
2009-02,BATS (Z),11453848745,7118517249,5114687271,23687053265,239737593609.0,278037493375.0,94457614969.1,612232701953.0,82547074,33866422,32370049,148783545
2009-02,BEX (B),46693975,147081526,28691451,222466952,862660726.493,6349054494.31,828317408.439,8040032629.24,275711,575278,116353,967342
2009-02,CBOE (W),66248800,157874200,50981600,275104600,1129336039.15,9889463898.16,1312153424.46,12330953361.8,55494,131225,166809,353528
2009-02,CHX (M),341433322,246659496,102040964,690133782,7504562683.63,14654824235.1,2539641420.94,24699028339.7,391651,141605,113273,646529
2009-02,ISE (I),1641063144,529905140,636544403,2807512687,23771551468.0,13113397737.3,7868171923.29,44753121128.6,6046844,1181154,2088466,9316464
2009-02,NASDAQ (DQ),31258978243,11217617063,13117986052,55594581358,464167173539.0,326647467809.0,193531487532.0,984346128880.0,77321384,17477891,29696529,124495804
2009-02,NASDAQ (Q),22533171929,13821260620,17159267524,53513700073,430623954309.0,574457617108.0,315677819886.0,1.3207593913e+12,128079433,50464894,72768439,251312766
2009-02,NSX (C),802305563,211331675,263053924,1276691162,13605637048.7,7317099987.09,5012583367.6,25935320403.4,3097180,459326,1118388,4674894
2009-02,NYSE (DN),169544976,14912300,146729136,331186412,3001272930.69,414896259.432,2139098150.44,5555267340.56,394872,25755,322214,742841
2009-02,NYSE (N),30050001769,2100,198900,30050202769,566485925856.0,37747.0,3676245.0,566489639848.0,98556578,3,500,98557081
2009-02,NYSE Arca (P),19682609672,11445182588,6829608383,37957400643,371523838646.0,435529016863.0,128874414513.0,935927270022.0,112969430,37889293,35574852,186433575
2009-03,ADF (D),973626215,71949887,301578790,1347154892,17837986111.4,2391623062.3,4893566340.25,25123175514.0,3411574,178868,1110841,4701283
2009-03,AMEX (A),0,275099175,0,275099175,0.0,1169102289.96,0.0,1169102289.96,0,483200,0,483200
2009-03,BATS (Z),14953370557,8683367118,5975507002,29612244677,291448256261.0,312352749709.0,108772374859.0,712573380830.0,100496985,39000421,38418546,177915952
2009-03,BEX (B),317878875,381674532,185876795,885430202,6407373670.44,16453679459.3,4547324432.68,27408377562.5,2140043,1476104,1022363,4638510
2009-03,CBOE (W),137772600,176113600,51487200,365373400,1508912409.92,9835301756.62,1355318186.37,12699532352.9,64311,116325,166020,346656
2009-03,CHX (M),471427704,343323896,131766244,946517844,9238602884.3,18694802586.6,3212579270.07,31145984741.0,445173,196376,124611,766160
2009-03,ISE (I),2700919635,1025881391,877774787,4604575813,31580873064.3,18249602780.3,10108528806.6,59939004651.2,8249339,1744795,2766980,12761114
2009-03,NASDAQ (DQ),48792652870,17222349653,16944384959,82959387482,624307690922.0,447088637166.0,240272170222.0,1.31166849831e+12,108175644,25909133,38810700,172895477
2009-03,NASDAQ (Q),26496345257,15783121758,18747449633,61026916648,455329847110.0,577007198953.0,331943693966.0,1.36428074003e+12,137067713,50028523,76814560,263910796
2009-03,NSX (C),1225530329,150767419,330511800,1706809548,18404141918.8,5845292437.34,6244734204.94,30494168561.1,4330905,486759,1460203,6277867
2009-03,NYSE (DN),297344818,24775556,212352593,534472967,5116605871.67,797323100.772,3191504756.95,9105433729.39,714058,45776,488869,1248703
2009-03,NYSE (N),39860383035,1900,196700,39860581635,681513276698.0,15140.0,3174778.5,681516466617.0,111054313,4,581,111054898
2009-03,NYSE Arca (P),24819369330,14032257251,7713751022,46565377603,446197489398.0,486485719164.0,147198660433.0,1.079881869e+12,133788478,44164770,41292676,219245924
2009-04,ADF (D),803903751,57075123,291239127,1152218001,15907670773.5,1879067584.9,5220724098.21,23007462456.6,2871240,140153,1020316,4031709
2009-04,AMEX (A),0,287297517,0,287297517,0.0,1149805464.31,0.0,1149805464.31,0,493047,0,493047
2009-04,BATS (Z),11456382602,7000583195,5111179159,23568144956,230559923794.0,222277843486.0,96773493035.2,549611260315.0,75839402,29292190,32275789,137407381
2009-04,BEX (B),836201804,603391746,386172730,1825766280,16072704228.7,21673249949.9,11109048703.5,48855002882.2,5045718,2208283,2397469,9651470
2009-04,CBOE (W),203055700,183010000,58287300,444353000,1919736899.18,9007672080.2,1680698331.17,12608107310.5,76703,162071,133511,372285
2009-04,CHX (M),404933985,225574324,154288584,784796893,8186008413.49,12643963709.5,3429521373.44,24259493496.4,351411,132973,112749,597133
2009-04,ISE (I),3368244694,1072418703,1375828983,5816492380,48618638332.3,20993385169.8,16942758181.0,86554781683.2,11142052,2055194,3888759,17086005
2009-04,NASDAQ (DQ),44012151641,17030935150,17595133052,78638219843,654951865867.0,403065851993.0,270341339630.0,1.32835905749e+12,103744289,25390289,39925896,169060474
2009-04,NASDAQ (Q),21156896885,11391287167,16561011427,49109195479,415922037502.0,424366523413.0,325258619258.0,1.16554718017e+12,114536631,35708537,70466697,220711865
2009-04,NSX (C),876457691,306186992,376194320,1558839003,15804867921.3,7052399786.41,6261027787.76,29118295495.4,3410702,542660,1416643,5370005
2009-04,NYSE (DN),275153559,28965185,219603163,523721907,5711070300.3,872376824.535,3772432039.91,10355879164.8,728372,42388,486053,1256813
2009-04,NYSE (N),33217094506,400,209600,33217304506,648732093614.0,2697.0,3784153.0,648735880464.0,97930862,4,582,97931448
2009-04,NYSE Arca (P),19956299110,11589283409,7146666596,38692249115,398141260032.0,394690731339.0,146391073712.0,939223065084.0,107793124,34511992,36698717,179003833
2009-05,ADF (D),631489673,82813789,240449586,954753048,12564954750.8,2090653366.52,4170807964.53,18826416081.9,2211477,152483,830897,3194857
2009-05,AMEX (A),0,358696567,0,358696567,0.0,1204058442.41,0.0,1204058442.41,0,578950,0,578950
2009-05,BATS (Z),11051847589,6754429854,5214907274,23021184717,235277158798.0,200737848053.0,95396904163.5,531411911015.0,73076909,25231828,32074981,130383718
2009-05,BEX (B),1196755752,572347185,334474073,2103577010,22731215162.3,18204709235.5,10021393148.6,50957317546.3,6547692,1772920,1935085,10255697
2009-05,CBOE (W),147574500,183865100,65607100,397046700,2534749260.02,7974293053.15,1778056609.94,12287098923.1,111645,169388,166970,448003
2009-05,CHX (M),403550055,260333398,154161047,818044500,7977377753.36,18888055760.0,2906329488.04,29771763001.4,291894,106837,121069,519800
2009-05,ISE (I),2887642195,838442384,1305887722,5031972301,48028052830.2,17766765219.3,15740726720.9,81535544770.3,10064376,1598951,3640667,15303994
2009-05,NASDAQ (DQ),42687329338,17733077208,18139795356,78560201902,701345434759.0,399235276437.0,262685780200.0,1.3632664914e+12,100153945,25336844,39082705,164573494
2009-05,NASDAQ (Q),19098874000,10137900640,15479748838,44716523478,410505634814.0,387812489676.0,297600493362.0,1.09591861785e+12,98474987,29689470,62116549,190281006
2009-05,NSX (C),836889373,474183709,439784078,1750857160,16218267808.0,7525563598.34,5508809844.46,29252641250.8,3388790,554232,1327386,5270408
2009-05,NYSE (DN),335417307,59512354,244743030,639672691,7251052020.48,1882365009.42,4157193366.1,13290610396.0,850286,79975,603857,1534118
2009-05,NYSE (N),31019873183,1500,567300,31020441983,649068324106.0,28632.0,10932932.0,649079285670.0,92379676,8,1179,92380863
2009-05,NYSE Arca (P),18609315718,10686393857,6678452677,35974162252,391526013142.0,357780595805.0,131463021897.0,880769630844.0,97854311,29961861,33894306,161710478
2009-06,ADF (D),593556600,93689890,263921040,951167530,13418206882.8,3035668841.05,4941251318.0,21395127041.9,2356660,187419,968455,3512534
2009-06,AMEX (A),0,526600602,0,526600602,0.0,1805099297.42,0.0,1805099297.42,0,693631,0,693631
2009-06,BATS (Z),10413866928,6328096677,5787930481,22529894086,233400029218.0,201617051801.0,106874585086.0,541891666106.0,70526575,23792904,34024868,128344347
2009-06,BEX (B),1590821577,626530363,547529169,2764881109,30989284234.0,21836763949.1,13989791059.7,66815839242.8,8465109,2222130,2922469,13609708
2009-06,CBOE (W),153570100,168088400,74139300,395797800,2389735133.03,7911835474.96,1948387452.23,12249958060.2,107067,137240,176031,420338
2009-06,CHX (M),383397649,345457840,194413906,923269395,8169439836.43,22858078771.4,3376124154.34,34403642762.1,249008,123292,131615,503915
2009-06,ISE (I),2258104449,760499515,1372801008,4391404972,40813072642.3,18335278761.6,17754488957.3,76902840361.2,8487198,1599368,3929104,14015670
2009-06,NASDAQ (DQ),37135709208,15881174978,21276211412,74293095598,677119918672.0,402048140306.0,312255416449.0,1.39142347543e+12,91793375,24332145,42928834,159054354
2009-06,NASDAQ (Q),16202564512,8691446627,17011711485,41905722624,378826860946.0,367568032083.0,328219855016.0,1.07461474805e+12,88180353,27216643,62625319,178022315
2009-06,NSX (C),773457765,477274091,568507489,1819239345,17008000479.2,7332345646.68,7098727079.63,31439073205.5,3653257,580977,1537536,5771770
2009-06,NYSE (DN),374049453,84489912,316323280,774862645,8388832667.97,2577677333.66,5322626538.09,16289136539.7,975486,114119,761771,1851376
2009-06,NYSE (N),28838969283,4400,979400,28839953083,632908406066.0,179108.0,16481449.0,632925066623.0,82138087,5,2065,82140157
2009-06,NYSE Arca (P),15437315730,9887933411,6721648673,32046897814,355463186671.0,359898172933.0,137050455408.0,852411815012.0,86462521,29777375,33129940,149369836
2009-07,ADF (D),594294600,60969133,251607700,906871433,13506022961.0,2346539359.78,5297659321.21,21150221642.0,2268165,145615,968043,3381823
2009-07,AMEX (A),0,284378193,0,284378193,0.0,1160928057.93,0.0,1160928057.93,0,512249,0,512249
2009-07,BATS (Z),10078671599,5249790189,5505277077,20833738865,209159938230.0,186729955779.0,105300837485.0,501190731494.0,61671666,21152764,30941191,113765621
2009-07,BEX (B),2518649709,614639860,843678491,3976968060,44707281135.4,22819055377.5,18163699549.9,85690036062.8,13057024,2447898,4293084,19798006
2009-07,CBOE (W),156460700,111594100,56939100,324993900,2412151675.18,5967224480.06,1626528952.16,10005905107.4,151551,125297,127698,404546
2009-07,CHX (M),419435309,271381702,169000336,859817347,7855910911.77,18361015489.8,3106720899.88,29323647301.4,198855,93473,108223,400551
2009-07,ISE (I),2313763829,482780835,1039596170,3836140834,38879224338.5,14649117976.7,15645661920.0,69174004235.2,8170973,1332010,3325703,12828686
2009-07,NASDAQ (DQ),37462129322,11736174519,18402892822,67601196663,648794192436.0,365066932090.0,313852981263.0,1.32771410579e+12,89111950,21948802,42674055,153734807
2009-07,NASDAQ (Q),16404982263,7449974034,15172734795,39027691092,369407719466.0,332889960903.0,327662415471.0,1.02996009584e+12,85768088,25415517,61605184,172788789
2009-07,NSX (C),517613720,272555935,357356355,1147526010,9363707730.93,5828569661.1,3762585505.51,18954862897.5,2454906,490494,1156430,4101830
2009-07,NYSE (DN),396576908,69477413,296292848,762347169,9252867499.97,2517149299.31,5648366510.71,17418383310.0,1085245,107495,722345,1915085
2009-07,NYSE (N),25554822425,4600,1018400,25555845425,546430843904.0,32195.0,15388865.0,546446264964.0,75042461,20,2500,75044981
2009-07,NYSE Arca (P),14455544329,7616308582,6239366788,28311219699,320877364114.0,298786139505.0,139816992590.0,759480496209.0,75616602,24098991,30822973,130538566
2009-08,ADF (D),688472230,72958150,238513730,999944110,12485693693.9,2596840161.82,4631920608.71,19714454464.5,2169030,167738,983421,3320189
2009-08,AMEX (A),0,427786421,0,427786421,0.0,1524533665.33,0.0,1524533665.33,0,584575,0,584575
2009-08,BATS (Z),10670288362,4337614496,4848388406,19856291264,199156594255.0,164468589816.0,92186520240.4,455811704311.0,54777600,17084458,27069113,98931171
2009-08,BEX (B),3797293981,651093087,798683435,5247070503,50887136951.0,24291055449.0,15549341091.1,90727533491.1,13262786,2616693,3848928,19728407
2009-08,CBOE (W),94766500,93368800,50674900,238810200,2243122761.1,5700421320.27,1546995353.15,9490539434.52,126144,94697,113610,334451
2009-08,CHX (M),387432965,245510870,198486185,831430020,7977282442.07,17682223789.0,2926236542.39,28585742773.5,241738,81756,122373,445867
2009-08,ISE (I),2648124234,528446830,1210507133,4387078197,41926473385.5,14601786707.9,16704483334.8,73232743428.2,8004034,1367511,3724020,13095565
2009-08,NASDAQ (DQ),46132469430,10863125789,17873782484,74869377703,669486754219.0,339283754848.0,272667990495.0,1.28143849956e+12,85778077,19194928,38938992,143911997
2009-08,NASDAQ (Q),16572927786,6970163165,13527144251,37070235202,345605188047.0,338875081940.0,282511422179.0,966991692168.0,74339870,23309614,53268423,150917907
2009-08,NSX (C),593135005,283449993,452139125,1328724123,10080421856.7,6433204301.82,3923700747.05,20437326905.5,2422007,534153,1148212,4104372
2009-08,NYSE (DN),331260068,69247668,253592636,654100372,7887718133.51,2692007485.84,4605340821.19,15185066440.5,857422,96201,587986,1541609
2009-08,NYSE (N),25451510827,3900,634700,25452149427,545239652398.0,31260.5,11230261.5,545250913920.0,67555524,20,1721,67557265
2009-08,NYSE Arca (P),15421683205,6894202338,5659220719,27975106262,303293400932.0,288325149832.0,118961833271.0,710580384036.0,66842641,21111527,27110464,115064632
2009-09,ADF (D),886862060,70807120,273075550,1230744730,12547508401.5,2472130158.22,4863388485.75,19883027045.5,2037366,199029,1033622,3270017
2009-09,AMEX (A),0,563628809,0,563628809,0.0,2140723739.87,0.0,2140723739.87,0,821368,0,821368
2009-09,BATS (Z),9463146661,4456703486,4916313958,18836164105,191309853508.0,172790100139.0,97569855865.5,461669809513.0,49341904,16775921,26562139,92679964
2009-09,BEX (B),4552166164,793892202,1289761371,6635819737,79003940509.3,29010001952.6,24684412871.1,132698355333.0,23875960,3576695,7361480,34814135
2009-09,CBOE (W),89259300,96655100,48731500,234645900,2273329856.15,5513718288.18,1521251145.04,9308299289.37,211623,131948,171402,514973
2009-09,CHX (M),301353784,297408971,203563549,802326304,8393755473.07,21002430541.2,4080368289.36,33476554303.6,203074,91818,121391,416283
2009-09,ISE (I),2330240548,546096699,1308794638,4185131885,42181391553.4,14659224768.0,18770076917.7,75610693239.2,7301573,1242701,3771250,12315524
2009-09,NASDAQ (DQ),41158550830,11067187488,20422378204,72648116522,715756699970.0,340037757117.0,324464790506.0,1.38025924759e+12,82182096,18150161,40354221,140686478
2009-09,NASDAQ (Q),16641449429,7320237278,15143334142,39105020849,370899554088.0,356256925760.0,316564298960.0,1.04372077881e+12,75635620,23998203,56713013,156346836
2009-09,NSX (C),497640608,323987729,546591631,1368219968,12163658324.3,6246289120.12,3934812877.66,22344760322.0,2702862,565744,1435527,4704133
2009-09,NYSE (DN),361376371,74873851,290701087,726951309,9312812616.5,3482766818.56,5442896261.07,18238475696.1,854096,80221,606189,1540506
2009-09,NYSE (N),28921454270,400,195600,28921650270,682794881614.0,2791.5,3671607.5,682798556014.0,78358437,3,655,78359095
2009-09,NYSE Arca (P),13291402497,6738158558,6184452594,26214013649,296669446770.0,283519796088.0,130503917023.0,710693159881.0,62015100,20216106,27554853,109786059
2009-10,ADF (D),605142720,69676420,300210300,975029440,12806585148.9,2604800109.72,6122092126.7,21533477385.3,2231549,213238,1133848,3578635
2009-10,AMEX (A),0,496683403,0,496683403,0.0,2009245400.82,0.0,2009245400.82,0,839552,0,839552
2009-10,BATS (Z),9051986245,5093493880,5099391967,19244872092,204702167916.0,209448428487.0,110245426186.0,524396022589.0,52240800,18329037,29030259,99600096
2009-10,BEX (B),4993858241,903132365,1609669289,7506659895,90639223359.5,32885753580.8,31720154582.7,155245131523.0,27951949,3854576,9652301,41458826
2009-10,CBOE (W),87063200,95558100,49862000,232483300,2139046126.07,5406688904.94,1605447772.09,9151182803.1,195382,128761,149097,473240
2009-10,CHX (M),339438058,312905852,191146686,843490596,10590034377.2,23976281145.9,7187760829.1,41754076352.2,209653,119409,111068,440130
2009-10,ISE (I),2005360179,453552279,1122021708,3580934166,39007944143.6,14895824383.2,20407120972.6,74310889499.4,6614667,1181444,3822861,11618972
2009-10,NASDAQ (DQ),39004657989,11541450685,19675776638,70221885312,772899849976.0,395983626029.0,373573471769.0,1.54245694777e+12,87760667,19102034,43635483,150498184
2009-10,NASDAQ (Q),18132670461,8862383975,16258181969,43253236405,442928327712.0,447347652806.0,388299909371.0,1.27857588989e+12,89799030,28429687,65691282,183919999
2009-10,NSX (C),524326303,281803742,511877041,1318007086,12599832953.2,6816832663.82,4435709901.85,23852375518.8,2569445,524520,1346469,4440434
2009-10,NYSE (DN),400622911,89978756,299837474,790439141,11052624568.3,4610085757.78,6343231671.27,22005941997.4,887038,86254,637280,1610572
2009-10,NYSE (N),28789794503,0,8200,28789802703,726401461322.0,0.0,112225.0,726401573547.0,83725284,0,7,83725291
2009-10,NYSE Arca (P),13582221878,7529528314,6327696161,27439446353,333900372023.0,336546393974.0,159110279649.0,829557045647.0,68458717,22384744,30296437,121139898
2009-11,ADF (D),461689754,97011830,243145610,801847194,10024542437.9,3284174830.89,4908923974.37,18217641243.1,1811858,274803,964081,3050742
2009-11,AMEX (A),0,315062632,0,315062632,0.0,1445123541.17,0.0,1445123541.17,0,603499,0,603499
2009-11,BATS (Z),6586621516,4365156223,4076015513,15027793252,152031668211.0,180458690723.0,84558184542.5,417048543476.0,37930168,15549879,22710329,76190376
2009-11,BEX (B),3390418253,755507492,993546422,5139472167,65966541897.2,27239266876.2,18290838264.4,111496647038.0,18578610,3087786,5749972,27416368
2009-11,CBOE (W),84140300,78631800,50661100,213433200,2420923208.19,4343996320.91,1842602562.15,8607522091.25,151892,125267,95742,372901
2009-11,CHX (M),269926731,277261060,153665008,700852799,9607589243.58,22859437849.0,5844295372.5,38311322465.0,167785,97163,73800,338748
2009-11,ISE (I),1344479150,365620854,818004166,2528104170,27553547553.7,11569586424.2,13998393433.5,53121527411.4,4772654,936531,2767012,8476197
2009-11,NASDAQ (DQ),28386928180,9607199252,14572334155,52566461587,583992816408.0,331643417456.0,276222243937.0,1.1918584778e+12,67875657,15645315,33958547,117479519
2009-11,NASDAQ (Q),14168694307,7132205868,12743155454,34044055629,363302567745.0,361384231060.0,295077855481.0,1.01976465429e+12,73223971,24699193,50986771,148909935
2009-11,NSX (C),408659886,217428211,384389943,1010478040,9691083408.7,5657367192.0,3254228890.74,18602679491.4,1863034,433357,882147,3178538
2009-11,NYSE (DN),1344764856,222846173,647747012,2215358041,33643708095.9,9987292137.65,13546097863.2,57177098096.7,4612617,334765,1967510,6914892
2009-11,NYSE (N),22206217677,0,13100,22206230777,577819300665.0,0.0,216675.0,577819517340.0,66279507,0,8,66279515
2009-11,NYSE Arca (P),9812209376,6186482809,4974790989,20973483174,247688330698.0,275517500825.0,115738794606.0,638944626129.0,50743214,18637982,23948794,93329990
2009-12,ADF (D),716834565,97092400,305177720,1119104685,12963541120.9,3020997201.98,6034861177.82,22019399500.7,2265737,252232,1295813,3813782
2009-12,AMEX (A),0,367957280,0,367957280,0.0,1601970994.06,0.0,1601970994.06,0,563062,0,563062
2009-12,BATS (Z),6964703399,3871494289,4196270426,15032468114,150206395372.0,160688564740.0,92134934124.2,403029894236.0,34101138,13442768,22281556,69825462
2009-12,BEX (B),3970816588,524915732,902222460,5397954780,76107941673.6,18732244600.1,15484077976.0,110324264250.0,18620471,1939129,4685796,25245396
2009-12,CBOE (W),144780000,84568400,61862500,291210900,3921886531.05,5763976335.89,2805985033.2,12491847900.1,121428,77596,50331,249355
2009-12,CHX (M),265481886,222222190,157654072,645358148,9850460543.93,15778998947.5,7012143886.35,32641603377.8,171180,94628,94945,360753
2009-12,ISE (I),1489273347,394095978,833733777,2717103102,31054313136.1,11162590162.9,13777418563.5,55994321862.5,5355578,938863,2675042,8969483
2009-12,NASDAQ (DQ),32960178339,8978640348,15727831890,57666650577,644626079903.0,311927986843.0,301561685882.0,1.25811575263e+12,69240249,14325302,35567837,119133388
2009-12,NASDAQ (Q),13128910011,5538505475,12082228399,30749643885,326929090000.0,281985348649.0,283427558727.0,892341997376.0,60847703,18297711,44892473,124037887
2009-12,NSX (C),379593533,255439862,489568725,1124602120,9394579187.6,3594563443.96,3294524414.28,16283667045.8,1884561,423137,1173639,3481337
2009-12,NYSE (DN),2048314666,287046175,805614734,3140975575,47929871081.7,12658560218.3,18317064976.1,78905496276.2,6518240,482818,2744782,9745840
2009-12,NYSE (N),24325580100,0,600,24325580700,609961287177.0,0.0,18134.0,609961305311.0,60000467,0,3,60000470
2009-12,NYSE Arca (P),10230770966,5580295772,4720276391,20531343129,231498222020.0,249012949550.0,110654426711.0,591165598281.0,43165176,15697612,21532957,80395745
